111111111111
100000001001
111101011011
110000000001
110111011101
110001011001
110100010011
110111000111
110011011111
111011000001
111000011101
111111111111